11111111111111111111111111111111111111111111111111
10000000000000022222222222222222220000000000000001
10000000000000233333333333333333332000000000000001
10000000000002333333333333333333333200000000000001
10000000000023333333333333333333333320000000000001
10000000000023333322222222222222333332000000000001
10000000000023333210000000000000233332000000000001
10000000000023332000000000000000023332000000000001
10010000000023332000000000000000023332000000000001
10000000000023332000000000100000023332000000000001
10000000000023332000000000000000023332000000000001
10000000000233332000000000000000023332000000000001
10000000002333320000000040000000023332000000000001
10000000023333200000000444001000023332000001000001
10000000233332000010004444400000023332000000000001
10000002333320000000044444440010023332000000000001
10000023333200000000044444440000023332000000000001
10000233332000000000044444444000023332001000000001
10002333320010000000004444444000002333200000000001
10023333200000000000444444444000002333320000000001
10233332000000000004444444444000000233332000100001
10233320000000000044444444444410000023333200000101
10233320000000000044444444444400000002333320000001
10233320000000000004444444444000000000233332000001
10233320000000000000444444440001000000233332000001
10233320000000000000044444400000000000023333200001
11233320000000000100004444100000000000002333320001
10233320000000000000000440000000000000000233332001
10235320000000000000000000000000000000000023333201
10233320000000000000000000000000000000000023333201
10233320000000222222200000000000000000000023333201
10233320000022333333320000000000000000000233332001
10233320000233333333333200000000000000002333320001
10233320002333333333333320000000000000023333320001
10233320002333322222333332000000000022233333200001
10233320002333320000233333222222222223333332000001
10233320002333320000023333333333333333333200000001
10233320002333320000002333333333333333332000000001
10233320002333320000000233333333333333320000000001
10233320002333332220000022222222222222200000000001
10233320002333333332222200000000000000000000000001
10233320000233333333333322000010000000000000000001
10233320000022333333333333200000000000000000000001
10233320000000222233333333200000000000000000000001
10233332222222222222223333320000000000000000000001
10233333333333333333333333370000000000000100000001
10233333333333333333333333320000000000000000000001
10023333333333333333333333200000000000000000000001
10002222222222222222222222000000000000000000000001
11111111111111111111111111111111111111111111111111