77777777777777777777777777777777777777777777777777
70000000000000044444444444444444440000000000000007
70000000000000430000000020000000004000000000000007
70000000000004300000000022000000000400000000000007
70000000000043000000000020000000000040000000000007
70000000000043000044444444444444300004000000000007
70000000000043000470000000000000430004000000000007
70000000000043004000000000000000043004000000000007
70070000000043004000000000000000043004000000000007
70000000000043004000000000700000043004000000000007
70000000000043004000000000000000043004000000000007
70000000000430004000000000000000043004000000000007
70000000004300040000000070000000043004000000000007
70000000043000400000000777007000043004000007000007
70000000430004000070007777700000043004000000000007
70000004300040000000077777770070043004000000000007
70000043000400000000077777770000043004000000000007
70000430004000000000077777777000043004007000000007
70004300040070000000007777777000004300400000000007
70043000400000000000777777777000004300040000000007
70430004000000000007777777777000000430004000700007
70430040000000000077777777777770000043000400000707
70430040000000000077777777777700000004300040000007
70430040000000000007777777777000000000430004000007
70430040000000000000777777770007000000430004000007
70430040000000000000077777700000000000043000400007
77430040000000000700007777700000000000004300040007
70430040000000000000000770000000000000000430004007
70430040000000000000000000000000000000000043000407
70430040000000000000000000000000000000000043000407
70430040000000444444400000000000000000000043222407
70430040000044300000040000000000000000000430024007
70430040000430000000000400000000000000004300040007
70430040004300000000000040000000000000043000040007
70430040004300044444300004000000000044430000400007
70430040004300040000430000444444444443000004000007
70430040004300040000043000000000000000000400000007
70430040004300040000004300000000000000004000000007
70430040004300040000000430000000000000040000000007
70430040004300004440000044444444444444400000000007
70431040004300000004444400000000000000000000000007
70411140000430000000000044000070000000000000000007
70430040000044300000000000400000000000000000000007
70430040000000444430000000400000000000000000000007
70430004444444444444443000040000000000000000000007
70430000000000000000000000060000000000000700000007
70430000000000000000000000040000000000000000000007
70043000000000000000000000400000000000000000000007
70004444444444444444444444000000000000000000000007
77777777777777777777777777777777777777777777777777