00000000000000007070707070707070707000000000000000
00000000700007044444444444444444440070000000000000
00000000000700430000000020000000004000700000000000
00007000000004300000000022000000000400007000000000
00000000070043000000000020000000000040000000000000
00007000000043000044444444444444300004007000000000
00000000700043000470000000000000430004000000000000
00000000000043004000000000000000043004000700000000
00070007000043004000000000000000043004000000000000
00000000000043004000000000700000043004000700000000
00000070000043004000000000000000043004000000000000
00007000000430004000000000000000043004000700000000
00000000004300040000000070000000043004000000000000
00007000043000400000000707007000043004070007000000
00000000430004000070007000700000043004000000000700
00700004300040000000070000070070043004000700000000
00000043000400000000070000070000043004000000000000
07000430004000000000070000007000043004007000070000
00004300040070000000007000007000004300400070000000
70043000400000000000700000007000004300040000000000
00430004000000000007000000007000000430004000700000
70430040000000000070000000000070000043000400000700
00430040000000000070000000000700000004300040000000
70430040000000000007000000007000000000430004000070
00430040000000000000700000070007000000430004000000
70430040000000000000070000700000000000043000400070
07430040000000000700007000700000000000004300040000
70430040000000000000000770000000000000000430004000
00430040000000000000000000000000000000000043000407
70430040000000000000000000000000000000000043000400
00430040000000444444400000000000000000000043222407
70430040000044300000040000000000000000000430024700
00430040000430000000004400000000000000004300040000
70430040004300000000000040000000000000043000047000
00430040004300044444300004000000000004430000400000
70430040004300040000430000444444444443000004700000
00430040004300040000043000000000000000000440000000
70430040004300040000004300000000000000004070000000
00430040004300040000000430000000000000040000000000
70430040004300004444400044444444444444407000000000
00431040004300000000044000000000707070700000000000
70511150000444430000000444000070000000000000000000
00430040000000044444300000440000000000000000000000
70430040000000000000430000040700000000000000000000
00430004444444444444430000040000000000000000000000
70430000000000000000000000040700000007000000000000
00430000000000000000000000040000000000000000000000
70043000000000000000000000440700000000000000000000
00704444444444444444444444007000000000000000000000
00007070707070707070707070700000000000000000000000