00000000000000007070707070707070707000000000000000
00000000700007555555555555555555555070000000000000
00000000000705430000000020000000000600700000000000
00007000000054300000000022000000000060007000000000
00000000070043000000000020000000000004000000000000
00007000000043000555555555555555300004007000000000
00000000700043005470000000000000630004000000000000
00000000000043004000000000000000043004000700000000
00070007000043004000000000000000043004000000000000
00000000000043004000000000700000043004000700000000
00000070000543004000000000000000043004000000000000
00007000005430054000000000000000043004000700000000
00000000054300540000000070000000043004000000000000
00007000543005400000000707007000043004070007000000
00000005430054000070007000700000043004000000000700
00700054300540000000070000070070043004000700000000
00000543005400000000070000070000043004000000000000
07005430054000000000070000007000063006007000070000
00054300540070000000007000007000004300600070000000
70543005400000000000700000007000006300060000000000
00430054000000000007000000007000000630006000700000
70430040000000000070000000000070000063000600000700
00430040000000000070000000000700000006300060000000
70430040000000000007000000007000000000430006000070
00430040000000000000700000070007000000630000400000
70430040000000000000070000700000000000063000600070
07430040000000000700007000700000000000006300060000
70430040000000000000000770000000000000000630006000
00430040000000000000000000000000000000000043000407
70430040000000000000000000000000000000000043222400
00430040000005555555500000000000000000000543025407
70430040000554300000065000000000000000005430054700
00430040000430000000000600000000000000054300040000
70430040004300000000000060000000000000543000547000
00430040004300055555000004000000000005430005400000
70430040004300040000630006555555555554300554700000
00430040004300040000063000000000000000005400000000
70430040004300040000006300000000000000054070000000
00430040004300060000000630000000000000040000000000
70430040004300006555500065555555555555547000000000
00431040006300000000065000000000707070700000000000
70411140000655530000000655000070000000000000000000
00430040000000065555300000600000000000000000000000
70430060000000000000430000040700000000000000000000
00430006555555555555430000040000000000000000000000
70430000000000000000000000040700000007000000000000
00630000000000000000000000540000000000000000000000
70063000000000000000000000400700000000000000000000
00706555555555555555555555407000000000000000000000
00007070707070707070707070700000000000000000000000