11111111111111111111111111111111111111111111111111
10000000000000077777777777777777770000000000000001
10000000000000733333333333333333337000000000000001
10000000000007333333333333333333333700000000000001
10000000000073333333333333333333333370000000000001
10000000000073333377777777777777333337000000000001
10000000000073333710000000000000733337000000000001
10000000000073337000000000000000073337000000000001
10010000000073337000000000000000073337000000000001
10000000000073337000000000100000073337000000000001
10000000000073337000000000000000073337000000000001
10000000000733337000000000000000073337000000000001
10000000007333370000000040000000073337000000000001
10000000073333700000000444001000073337000001000001
10000000733337000010004444400000073337000000000001
10000007333370000000044444440010073337000000000001
10000073333700000000044444440000073337000000000001
10000733337000000000044444444000073337001000000001
10007333370010000000004444444000007333700000000001
10073333700000000000444444444000007333370000000001
10733337000000000004444444444000000733337000100001
10733370000000000044444444444410000073333700000101
10733370000000000044444444444400000007333370000001
10733370000000000004444444444000000000733337000001
10733370000000000000444444440001000000733337000001
10733370000000000000044444400000000000073333700001
11733370000000000100004444100000000000007333370001
10733370000000000000000440000000000000000733337001
10735370000000000000000000000000000000000073333701
10733370000000000000000000000000000000000073333701
10733370000000777777700000000000000000000073333701
10733370000077333333370000000000000000000733337001
10733370000733333333333700000000000000007333370001
10733370007333333333333370000000000000073333370001
10733370007333377777333337000000000077733333700001
10733370007333370000733333777777777773333337000001
10733370007333370000073333333333333333333700000001
10733370007333370000007333333333333333337000000001
10733370007333370000000733333333333333370000000001
10733370007333337770000077777777777777700000000001
10733370007333333337777700000000000000000000000001
10733370000733333333333377000010000000000000000001
10733370000077333333333333700000000000000000000001
10733370000000777733333333700000000000000000000001
10733337777777777777773333370000000000000000000001
10733333333333333333333333370000000000000100000001
10733333333333333333333333370000000000000000000001
10073333333333333333333333700000000000000000000001
10007777777777777777777777000000000000000000000001
11111111111111111111111111111111111111111111111111