77777777777777777777777777777777777777777777777777
70000000000000044444444444444444440000000000000007
70000000000000433333333333333333334000000000000007
70000000000004333333333333333333333400000000000007
70000000000043333333333333333333333340000000000007
70000000000043333344444444444444333334000000000007
70000000000043333470000000000000433334000000000007
70000000000043334000000000000000043334000000000007
70070000000043334000000000000000043334000000000007
70000000000043334000000000700000043334000000000007
70000000000043334000000000000000043334000000000007
70000000000433334000000000000000043334000000000007
70000000004333340000000070000000043334000000000007
70000000043333400000000777007000043334000007000007
70000000433334000070007777700000043334000000000007
70000004333340000000077777770070043334000000000007
70000043333400000000077777770000043334000000000007
70000433334000000000077777777000043334007000000007
70004333340070000000007777777000004333400000000007
70043333400000000000777777777000004333340000000007
70433334000000000007777777777000000433334000700007
70433340000000000077777777777770000043333400000707
70433340000000000077777777777700000004333340000007
70433340000000000007777777777000000000433334000007
70433340000000000000777777770007000000433334000007
70433340000000000000077777700000000000043333400007
77433340000000000700007777700000000000004333340007
70433340000000000000000770000000000000000433334007
70433340000000000000000000000000000000000043333407
70433340000000000000000000000000000000000043333407
70433340000000444444400000000000000000000043333407
70433340000044333333340000000000000000000433334007
70433340000433333333333400000000000000004333340007
70433340004333333333333340000000000000043333340007
70433340004333344444333334000000000044433333400007
70433340004333340000433333444444444443333334000007
70433340004333340000043333333333333333333400000007
70433340004333340000004333333333333333334000000007
70433340004333340000000433333333333333340000000007
70433340004333334440000044444444444444400000000007
70433340004333333334444400000000000000000000000007
70433340000433333333333344000070000000000000000007
70433340000044333333333333400000000000000000000007
70431340000000444433333333400000000000000000000007
70411134444444444444443333340000000000000000000007
70433333333333333333333333360000000000000700000007
70433333333333333333333333340000000000000000000007
70043333333333333333333333400000000000000000000007
70004444444444444444444444000000000000000000000007
77777777777777777777777777777777777777777777777777